GGGGGGGGGGGGGGGGGGGG
GGGGGWGGGGWGGGGGGGGG
GGGGGGGMGMGGGGGGGGGG
GGGGGWGGGWGGGGGGGGGG
GMMGGWMMMGGGGGGGGGGG
GMMGGGWWGGGGGGGGGGGG
GMMGGGGGGGGGGGGGGGGG
GGGGGGGGWGGGGGGGGGGG
GGGGGGGGWWGGGGGGGGGG
GGGGGGGGWWGGGGGGGGGG
GGGBGGGGGWGGGGGGGGGG
GGGGGGGGGWWGGGGGGGGG
GGGGGGGWWWWWWWWWGGGG
GGGGGGGWWWWWWWWWGGGG
GGGGGGGWWWWGWWWWGGGG
GGGGGGGWWWWGWWWWGGGG
GGGGGGGWWWWGWWWWGGGG
GGGGGGGWWWWWWWWWGGGG
GGGGGGGWWWWWWWWWGGGG
GGGGGGGGGGGGGGGGGGGG