GGGGGGGGGGGGGGGGGGGG
GGGGGWGGGGWGGGGGGGGG
GGGGGGGMGMGGGGGGGGGG
GGGGGWGGGWGGGGGGGGGG
GMMGGWMMMGGGGGGGGGGG
GMMGGGWWGGGGGGGGGGGG
GMMGGGGGWGGGGGGGGGGG
GGGGGGGGGGGGGGGGGGGG
GGGGGGGGGGGGGGGGGGGG
GGGGGGGG0GGGGGGGGGGG
GGGBGGGGGGGGGGGGGGGG
GGGGGGGGGGGGGGGGGGGG
GGGGGGGGGGGGGGGGGGGG
GGGGGGGGGGGGGGGGGGGG
GGGGGGGGGGGGGGGGGGGG
GGGGGGGGGGGGGGGGGGGG
GGGGGGGGGGGGGGGGGGGG
GGGGGGGGGGGGGGGGGGGG
GGGGGGGGGGGGGGGGGGGG
GGGGGGGGGGGGGGGGGGGG