GGGGGGGGGGGGGGGGMMMMM
GGGGGGWGGGGWGGGGMMGMM
GGGGGGGGMGMGGGGGMMGMM
GGGGGGWGGGGGBGGGMMGMM
GGMMGGWMMGGGGGGGMMGMM
GGMMGGGGGGGGGGGGGGGGG
GGMMGGGGGGGGGGGGGGGGG
GGGGGGGGGGGGGGGGGGGGG
GGGGGGGGGGGGGGGGGGGGG
GWWWGGGGGGGGGGGGGGGGG
MWWMMMMMGGGGGGGGGGGGG
MWWWMWWWWWWGGGGGGGGGG
WWWWWWWWWWWWGGGGGGGGG
WWWWWWWGWWWWWGGGGGGGG
WWWWWWGGWWWWWGGGGGGGG
WWWWWWGGWWWWWGGGGGGGG
WGGGGGGWWWWWMMGGGGGGG
GGGGGGGWWWWWMMGGGGGGG
WWWWWWWWWWWWMMMMMMMMM
WWWWWWWWWWWMMMMMMMMMM
WWWWWWWWWWWMMMMMMMMMM
WWWWWWWWWWMMMMMMMMMMM
WWWWWWWWWMMMMMMMMMMMM
WWWWWWWWMMMMMMMMMMMMM
WWWWWWWMMMMMMMMMMMMMM
WWWWWWGGGGGGGGGGGGGGG
WWWWWGGGGGGGGGGGGGGGG
WWWWGGGGGGGGGGGGGGGGG
WWWGGGGGGGGGGGGGGGGGG
WWGGGGGGGGGGGGGGGGGGG
WGGGGGGGGGGGGGGGGGGGG